6 12 12 12 12 10 12 12 12 12 12 12 12 12 12 12 12 12 10 12 12 12 12 12 12 12 12 12 12 12 12 12 12 12 12 12 12 12 12 12 12 12 12 12 12 12 12 12 12 9
8 0 0 0 0 8 0 0 0 0 0 0 0 0 0 0 0 0 8 0 0 0 0 0 0 0 4 0 0 0 0 0 4 0 0 0 0 4 0 4 0 0 4 0 0 0 0 0 0 8
8 0 0 0 0 8 0 4 0 4 0 4 4 0 4 12 4 0 4 0 0 0 4 12 4 0 4 0 4 0 4 0 4 0 4 12 12 4 0 4 4 0 4 0 4 0 4 4 0 8
8 0 0 0 0 8 0 0 0 0 0 0 0 0 0 0 0 0 0 0 4 0 4 0 0 0 4 0 4 0 4 0 4 0 4 0 0 4 0 4 0 0 0 0 0 0 4 0 0 8
7 4 0 4 12 15 10 9 0 4 0 0 4 0 4 12 12 12 12 12 4 0 4 0 4 0 4 0 0 0 0 0 0 0 4 4 0 0 0 4 0 4 4 0 4 12 4 0 4 4
8 0 0 0 0 0 7 15 4 4 4 0 0 0 0 0 0 0 4 0 0 0 4 0 0 0 4 4 0 0 4 0 4 0 0 4 0 4 0 4 0 0 4 0 4 0 0 0 0 8
8 0 4 0 4 0 8 0 0 0 4 0 4 0 4 0 4 0 4 0 4 12 4 0 4 0 4 0 0 0 4 0 4 0 4 4 0 4 0 4 4 0 0 0 4 0 4 0 0 8
8 0 8 0 0 0 7 12 9 0 4 0 4 0 0 0 0 0 4 0 4 0 0 0 0 0 4 0 4 4 4 4 4 0 0 0 0 0 0 4 0 0 4 0 4 4 4 4 0 8
8 0 8 0 4 0 4 0 8 0 0 0 4 0 4 4 4 4 4 0 4 0 4 0 4 0 0 0 0 0 0 0 4 4 4 4 0 4 0 4 0 4 4 0 0 0 4 4 0 8
8 0 8 0 0 0 0 0 8 0 4 4 4 0 4 0 4 0 4 0 0 0 4 0 4 0 4 4 4 4 4 0 4 0 0 0 0 0 0 4 0 4 4 4 4 0 4 4 0 8
8 0 8 0 4 0 4 0 4 0 4 4 4 0 4 0 0 0 4 4 4 4 4 0 4 0 0 0 0 0 0 0 4 4 4 4 0 4 0 4 0 4 0 0 0 0 0 0 0 8
8 0 8 0 4 4 4 0 0 0 0 0 0 0 4 0 4 0 4 0 0 0 0 0 0 0 4 0 4 4 4 4 4 4 0 4 0 4 0 4 0 4 4 4 4 4 4 4 0 8
8 0 8 0 0 4 0 0 4 0 4 4 0 0 0 0 0 0 4 4 4 4 4 4 4 4 4 0 0 0 0 0 0 0 0 0 0 4 0 4 0 0 4 0 0 0 0 0 0 8
8 0 4 0 4 4 0 4 4 0 0 4 4 4 4 0 4 0 4 0 4 0 0 0 4 0 0 0 4 0 0 4 0 4 0 4 4 4 0 4 0 0 4 0 4 4 4 4 4 4
8 0 0 0 4 0 0 4 0 0 0 0 0 0 0 0 4 0 4 0 0 0 4 0 4 0 4 4 4 0 0 0 0 0 0 0 0 4 0 4 0 4 4 0 4 0 0 0 4 4
7 0 4 4 4 4 0 4 4 4 0 4 4 4 4 4 4 4 4 4 4 4 4 0 4 0 0 0 4 0 4 4 0 4 4 0 4 4 0 4 0 4 4 0 4 0 4 0 0 8
8 0 0 0 0 4 0 0 0 0 0 4 0 0 0 0 0 0 0 4 0 4 4 0 4 0 4 0 4 0 4 0 0 0 0 0 0 4 0 4 0 0 0 0 4 4 4 4 0 8
8 0 4 0 4 4 0 4 0 4 0 4 0 4 4 4 0 4 0 4 0 4 0 0 4 4 4 4 4 0 4 0 4 0 4 0 4 4 0 4 0 4 4 0 0 0 0 0 0 8
8 0 4 0 0 0 0 4 0 0 0 4 0 0 0 4 4 4 0 4 0 0 0 0 0 0 0 0 0 0 0 0 0 0 0 0 0 0 0 4 0 4 4 0 4 0 4 4 4 4
8 0 4 4 0 4 0 0 0 4 0 4 4 0 4 4 0 0 0 4 0 4 0 4 4 0 4 4 4 4 4 4 4 4 4 4 4 4 4 4 0 0 0 0 0 0 0 0 0 8
8 0 4 4 4 4 4 0 4 4 0 0 4 0 0 0 0 0 4 4 0 4 0 0 4 0 4 0 0 0 0 0 0 0 4 0 4 0 4 4 4 4 4 4 4 4 4 4 0 8
8 0 0 0 0 0 4 0 0 4 0 0 4 4 0 4 0 0 0 4 4 4 4 0 0 0 4 0 4 4 4 4 4 0 4 0 4 0 0 0 0 0 0 0 0 4 0 0 0 8
8 0 4 4 4 0 0 0 4 4 4 0 0 4 0 4 0 4 0 0 0 4 0 0 4 0 4 0 0 0 0 0 4 0 4 0 0 0 4 0 0 4 0 4 0 4 0 4 0 8
7 4 4 0 4 0 4 0 4 4 4 4 0 4 0 4 0 0 0 4 0 4 0 4 4 0 4 4 4 4 4 0 4 0 4 0 0 0 4 4 0 4 0 4 0 0 0 4 0 8
8 0 0 0 0 0 4 0 0 0 0 0 0 4 0 4 0 4 4 4 0 4 0 4 0 0 0 0 4 0 4 0 4 0 4 0 4 0 0 0 0 4 0 4 0 4 0 4 0 8
7 4 4 0 4 4 4 4 4 0 4 4 4 4 4 4 4 4 0 0 0 4 0 0 0 0 4 0 0 0 0 0 4 0 4 0 4 0 4 0 4 4 0 4 0 0 0 4 0 8
8 0 0 0 4 0 0 0 4 0 4 0 0 0 0 0 0 0 0 4 4 4 4 4 4 0 4 0 4 4 0 4 4 0 4 4 4 0 4 0 4 4 0 4 0 4 0 4 0 8
8 0 4 0 4 0 0 0 4 0 4 0 4 4 4 4 4 4 4 4 0 0 0 0 0 0 4 0 0 0 0 0 4 0 0 0 0 0 0 0 0 4 0 4 0 0 0 4 0 8
7 4 4 0 4 0 0 0 4 0 4 0 4 0 0 0 0 0 4 0 0 4 4 4 4 4 4 0 0 4 0 0 4 0 4 4 4 4 4 0 4 4 0 4 0 4 0 4 0 8
8 0 0 0 0 0 0 0 4 0 4 0 4 0 4 4 4 0 4 0 4 4 0 4 0 0 0 0 0 4 4 0 4 0 0 0 0 0 4 0 0 0 0 4 0 0 0 4 0 8
7 4 4 0 4 4 4 0 4 0 4 0 4 0 0 0 4 0 4 0 4 0 0 4 0 4 0 4 0 0 4 0 4 0 4 0 4 0 4 4 4 4 4 4 4 4 4 4 0 8
8 0 0 0 0 0 4 0 0 0 4 0 4 4 4 0 4 0 4 0 4 0 0 4 0 4 0 4 4 4 4 0 4 0 0 0 0 0 0 0 4 0 0 4 0 4 0 4 0 8
8 0 4 4 0 4 4 4 4 4 4 0 0 0 4 0 4 0 4 0 4 4 0 4 0 4 0 4 0 0 4 0 4 0 4 4 4 0 4 0 4 4 0 0 0 0 0 0 0 8
8 0 0 4 0 4 0 4 0 0 0 0 4 0 4 0 4 0 4 0 4 0 0 4 0 4 0 4 4 0 0 0 0 0 0 0 4 0 0 0 4 0 0 4 0 4 0 4 0 8
7 4 0 4 0 4 0 4 0 4 4 4 4 0 4 0 4 0 4 0 4 0 4 4 0 4 0 0 0 0 4 0 4 0 4 0 4 0 4 0 4 4 0 0 0 0 0 0 0 8
8 0 0 4 0 4 0 4 0 4 0 0 4 0 0 0 4 0 4 0 4 0 0 0 0 4 0 4 4 4 4 4 4 4 4 4 4 4 4 4 4 4 0 4 0 4 0 4 0 8
8 0 4 4 0 4 0 0 0 4 0 0 4 4 4 4 4 0 4 0 4 4 4 4 4 4 0 0 0 0 0 0 0 0 0 0 0 0 0 0 0 4 0 0 0 0 0 0 0 8
8 0 0 4 0 4 4 4 4 4 0 0 0 0 0 0 0 0 4 0 0 0 0 0 0 4 4 4 4 4 4 4 4 4 4 4 4 4 4 4 0 4 0 4 0 4 0 4 0 8
7 4 0 4 0 0 0 0 0 0 0 4 4 4 4 4 4 4 4 4 4 4 4 4 0 4 4 0 0 0 0 0 4 0 0 0 0 0 0 4 0 4 0 0 0 0 0 0 0 8
8 0 0 4 4 4 4 4 4 4 4 4 0 0 0 4 0 4 0 0 0 0 0 4 0 4 0 0 4 0 0 0 4 4 0 4 0 4 0 4 0 4 0 4 0 4 0 4 0 8
8 0 4 4 0 4 0 0 0 4 0 0 0 4 0 0 0 4 0 4 4 4 0 4 0 4 0 4 4 4 0 0 0 0 0 0 0 0 0 4 0 4 0 0 0 0 0 0 0 8
8 0 0 4 0 4 0 4 0 4 0 4 4 4 4 4 0 4 0 4 0 4 0 0 0 4 0 0 0 0 0 0 0 4 0 4 0 4 0 4 0 4 0 4 0 4 0 4 0 8
7 4 0 4 0 4 0 4 0 4 0 4 0 0 0 0 0 0 0 4 0 4 0 4 4 4 0 4 4 4 4 4 0 4 0 0 0 0 0 4 0 4 0 0 0 0 0 0 0 8
8 0 0 4 0 4 0 4 0 4 0 4 4 4 4 4 4 4 4 4 0 4 0 0 0 0 0 0 0 0 0 4 0 4 0 4 0 4 0 4 0 4 0 4 0 4 0 4 0 8
8 0 4 4 0 4 0 4 0 4 0 0 0 0 0 0 0 0 0 4 0 4 0 4 4 4 4 4 4 4 0 4 0 4 0 0 0 4 0 4 0 4 0 0 0 0 0 0 0 8
8 0 0 4 0 4 0 4 0 4 4 4 4 4 4 4 4 4 0 4 0 4 0 0 0 4 0 0 0 4 0 4 0 4 4 4 4 4 0 4 0 4 0 4 4 4 0 0 0 8
7 4 0 4 0 0 0 4 0 0 0 0 0 0 0 0 0 0 0 4 0 0 0 4 0 0 0 4 0 4 0 0 0 0 0 0 4 0 0 4 0 4 0 0 0 4 0 0 0 8
8 0 0 4 4 4 4 4 4 4 4 4 4 4 4 4 4 4 4 4 4 0 4 4 4 4 4 4 0 4 4 4 4 4 4 0 4 0 4 4 0 4 4 4 0 4 0 0 0 8
7 4 0 0 0 0 0 0 0 0 0 0 0 0 0 0 0 0 0 0 0 0 4 0 0 0 0 0 0 0 0 0 0 0 0 0 4 0 0 0 0 0 0 0 0 4 0 0 0 8
4 4 12 12 12 12 12 12 12 12 12 12 12 12 12 12 12 12 12 12 12 12 12 12 12 12 12 12 12 12 12 12 12 12 12 12 12 12 12 12 12 12 12 12 12 12 4 0 4 13